
NO ./path_to_the_south_texture  
SO ./path_to_the_south_texture   
WE ./path_to_the_west_texture
EA ./path_to_the_east_texture  

F 255,9,01
C 255,30,65

        11111111111111111111111111111
        100000001010000001   1000000011
        10110000011100000111100001111
        1001000000000000000000001
111111111011000001110000000000001
11111111111111111111111111111111
111111111111111111111111111111
10000000001100000111011111111111
111101111111110111000000100011  
111101111111110111010100100001
11000001101010111000001000111
10000000000000001100000010001
1000N0000001010111010100100011
11000001110111111101111000111
11110111 11111 1 101111010001
11111111 1011 11111111111111
11111111 1111111 111111111111
